X                                                                                                                                                          P                                                                                                                        XXXXXXXXXXXXXXXXXXXXXXXXXXX
XXXXXXXXXXXXXXXXXXXXXXXXX
X                                                                                                                                                                                                                                                                                                           
X                                                                                                                                                                                                               
XXXXXXXXXXXXXXXXXXXXXXX
XXXXXXX
X                                                                                                  
 XXXXXXXXXX                                                                                
 X                   XXXXX   
       XXXXX                                                                                             XX             XX                                                 


XXXXXXXXXXXXXXXXXXXXXXXXXXXXXXX
XXXXXXXXXXXXXXXXXXXXXXX                                        
X
XXXXXXXXXXXXXXXXXXXXXXXXXXXXXXXX
XXXXXXXXXXXXXXXXXXXXX            
XXXXXXXXXXXXXXXXXX





X                                    
 S            






						XXXXXXXXXXXX
						XXXXXXXXXXX


		W                   F          
		    B               Y   
		XXXXXXXXXXXXXXX        
		                 X        XXXXX
		                 XXXXX            
		                 V          R         
		                 N            C    
		                  XX 

			W                   F            
			  B               Y                            
			X       
			 XXXXX
			 XXXXX            V         
			  R         N            C     
			 XX                                                 






XXXXXXXXXXXXXXXXXXXXXXXXXXXXXXXXXXXXXXXX
XXXXXXXXXXXXXX                                     
 XXXXXXXXXXXXXX




XXXXXXXXXXXXXXXXXXXXXXXXXXXXXXXXXXXXXXXXXXXXX
XXXXXXXXXXXXXXXXXXXXXXX




QQQQQQQXXXXXXXXXXXXXXXXXXXXXXXXXXXXXXXXX
XXXXXXXXXXXXXXXXXXXXXXXXXXXXXXXXXXXXXXXXXXXXXXXXXX
XXXXXX        
XXXXXXXXXXXXXXXXXXXXXXXXXXXXXXXX
XXXXXXX
XXXXXXXXXXXXXXXXXXXXXXXXXXXXXXXXXX
XXXXXXXXXXXXXXXXXXXXXXXXXXXXXXXXXXXXXXXXXX