X                                                                                                                                                                                                                                            P                                      XXXXXXXXXXXXXXXXXXXXXXXXXXXXXXXXXXXXXXXXXXXXXXXXXXXX
X                                                                                                                                                                                                                                                                                                           
X                                                                                                                                                                                                               XXXXXXXXXXXXXXXXXXXXXXXXXXXXXX
X                                                                                                  
 XXXXXXXXXX                                                                                X                   XXXXX         XXXXX                                                                                             XX             XX                                                 


XXXXXXXXXXXXXXXXXXXXXXXXXXXXXXXXXXXXXXXXXXXXXXXXXXXXXX                                        X
XXXXXXXXXXXXXXXXXXXXXXXXXXXXXXXXXXXXXXXXXXXXXXXXXXXXX            XXXXXXXXXXXXXXXXXX




X                                     S            





						XXXXXXXXXXXXXXXXXXXXXXX


		W                   F              B               Y   XXXXXXXXXXXXXXX        
		                 X        XXXXXXXXXX            V          R         N            C     XX 

			W                   F              B               Y                            X       
			 XXXXXXXXXX            V          R         N            C     XX                                                 






XXXXXXXXXXXXXXXXXXXXXXXXXXXXXXXXXXXXXXXXXXXXXXXXXXXXXX                                      XXXXXXXXXXXXXX




XXXXXXXXXXXXXXXXXXXXXXXXXXXXXXXXXXXXXXXXXXXXXXXXXXXXXXXXXXXXXXXXXXXX




QQQQQQQXXXXXXXXXXXXXXXXXXXXXXXXXXXXXXXXXXXXXXXXXXXXXXXXXXXXXXXXXXXXXXXXXXXXXXXXXXXXXXXXXXX
XXXXXX        
XXXXXXXXXXXXXXXXXXXXXXXXXXXXXXXXXXXXXXXXXXXXXXXXXXXXXXXXXXXXXXXXXXXXXXXXXXXXXXXXXXXXXXXXXXXXXXXXXXXXXXXXXXXXXXXXXXX