
X                                                                                                                                                                                                                                                                                                                                                                                                                       X                            
X                                                                                                                                                                                                                                         NP                                                                                                                                                                             X                            
X                                                                                                                                                                                                                                        XXX                                                                                                                                                                            X                            
X                                                                                                                                                                                                                                                                                                                                                                                                                       X                            
X                                                                                                                                                                                                                                                                                                                                                                                                                       X                            
X                                                                                                                                                                                                                                                                                                                                                                                                                       X                            
X                                                                                                                                                                                                                                              R                                                                                                                                                                        X                            
X                                                                                                                                                                                                                                 FXXXX       XXX                                                                                                                                                                       X                            
X                                                                                                                                                      X                            
X                                                                                                                                                                                                                          XXXX                                                                                                                                                                                         X                            
X                                                                                                                                                                                                                      XXXX                                                         X                            
X                                                                                                                                                                                                                  XXXX                                                                                                                                                                                                 X                            
X                                                                                                                                                                                                              XXXX                                                                                                                                                                                                     X                            
X                                                                                                                                                                                                          XXXX       X                            
X                                                                                                                                                                                                      XXXX                                                                         X                            
X                                                                                                                                                                                                  XXXX                                                                                                                                                                                                                 X                            
X                                                                                                                                                                                              XXXX                                                                                                                                                                     X                            
X                                                                                                                                                                                          XXXX                                                                                                                                                                                                                         X                            
X                                                                                                                                                                                      XXXX                                                                                                                                                                                                                             X                            
X                                                                                                                                                                                  XXXX                                                                                                     X                            
X         						                                                                                                                                               XXXX                                                                                                                                                                                                                                     X                            
X         						                                                                                                                                                                                                                                                                                    X                           						                                                                                                         XXXX                                                                                                                                                                                                                                             X                            
X                                                                                                                                                                 XXXXX                                                                                                                                                                                                                                             R  NX                            
X                                                                                                                                                                                                                                                                                                                                                                                                         XXXXXXXXXXXXXXT                            
X                                                                                                                                                                                                                                                                                                                                                                                                                       T                            
X                                                                     XX                                                                              XX                                                                                               X        XX                                                                                                                               XXXXXXXX               T                    
X                                                                     XX                                                                              XX                                                                                              XX        XX                                                                                                                                                      T                    
X                                           XX                                                                    XXXXX     XX                                                                                             XXX        XX                                                                                                                       XXXXXXX                      T                    
XXXXXXXXXXXXXXXXXXXXXXXXXXX XXXXXXXXXXXXXXXXXXXXXXXXXXXXXXXXXXXXXXXXXXXXXXXXXXXXXXXXXXXXXXXXXXXXXXXXX                                                                  XX                                                                                            XX                                                                                                                                                     T                    
X                                                                     XX                        SS                                 XXXXX               XX                                                                                           XXXXX        XX                                                                                               T                    
X                                                                     XXXXXXXXXXXXXXXXX                                     S                         XX                                                                                          XXXXXX        XX                                                                                                                                       T                    
X                                             N        S                                                                  XXXXXX                    XX                                                                                        XXXXXXX        XX                B            XXXXXXXXXX                                                             B                                                 T                    
X  XXXXXXXXXXXXXXXXXXXXXXXXXXXXXXXXXXXXXXXXXXXXXXX        




                           XXXXXX                      XX                                                                                        XXXXXXXXE E E E XX            XXXXXXXXXX                                                                        XXXXXXXXXXX                                 F           T                    
X                  B          N                                                          F B   E  Y   W                                E           XX      F 

                         N                            F        XXXXXXXXXXXXXXXXXXXXXXXXN  C   NXX    B  


           B                             N                                                     B                            E           T      T       T      T
XXXXXXXXXXXXXXXXXXXXXXXXXXXXXXXXXXXXXXXXXXXXXXXXXXXXXXXXXXXXXXXXXXXXXXXXXXXXXXXXXXXXXXXXXXXXXXXXXXXXXXXXXXXXXXXXXXXXXXXXXXXXXXXXXXXXXXXXXXXXXXXXXXXXXXXXXXXXXXXXXXXXXXXXXXXXXXXXXXXXXXXXXXXXXXXXXXXXXXXXXXXXXXXXXXXXXXXXXXXXXXXXXXXXXXXXXXXXXXXXXXXXXXXXXXXXXXXXXXXXXXXXXXXXXXXXXXXXXXXXXXXXXXXXXXXXXXXXXXXXXXXXXXXXXXXXXXXXXXXXXXXXXXXXXXXXXXXXXXXXXXXXXXXXXXXXXXXXXXXXXXXXXXXXXXXXXXXXXXXXXXXXXXXXXXXXXXXXXXXXXXXXXXXXX                    